陈晓霞	3D测试组	广东三维家信息科技有限公司
陈仙赐	3D测试组	广东三维家信息科技有限公司
周肖云	3D测试组	广东三维家信息科技有限公司
郭珂珂	3D测试组	广东三维家信息科技有限公司
骆森	3D测试组	广东三维家信息科技有限公司
何倚帆	3D测试组	广东三维家信息科技有限公司
孔芸芸	3D测试组	广东三维家信息科技有限公司
邓旭权	3D测试组	广东三维家信息科技有限公司
王事超	3D测试组	广东三维家信息科技有限公司
贺梦凡	3D基础体验组	广东三维家信息科技有限公司
王玉洁	3D基础体验组	广东三维家信息科技有限公司
邹咏筠	3D基础体验组	广东三维家信息科技有限公司
郭佩仪	3D基础体验组	广东三维家信息科技有限公司
麦进志	3D基础体验组	广东三维家信息科技有限公司
宋梦宇	3D基础体验组	广东三维家信息科技有限公司
李富昌	3D基础体验组	广东三维家信息科技有限公司
汪顺东	3D基础体验组	广东三维家信息科技有限公司
翁继胜	3D基础体验组	广东三维家信息科技有限公司
王俊义	3D基础体验组	广东三维家信息科技有限公司
詹学桂	3D基础体验组	广东三维家信息科技有限公司
杨九菊	3D模型开发组	广东三维家信息科技有限公司
黄武聪	3D体验组	广东三维家信息科技有限公司
王安安	3D体验组	广东三维家信息科技有限公司
王丽	3D体验组	广东三维家信息科技有限公司
史雪瑞	3D体验组	广东三维家信息科技有限公司
郜兴磊	3D体验组	广东三维家信息科技有限公司
钟威	3D体验组	广东三维家信息科技有限公司
罗元雷	3D引擎组	广东三维家信息科技有限公司
汪月娇	3D引擎组	广东三维家信息科技有限公司
孙中伟	3D引擎组	广东三维家信息科技有限公司
孔令雪	3D引擎组	广东三维家信息科技有限公司
胡创辉	3D智慧设计产品技术部	广东三维家信息科技有限公司
卢悦爽	3D智慧设计产品技术部公共	广东三维家信息科技有限公司
何为	3D中台技术部	广东三维家信息科技有限公司
钟沈辰	3D中台技术部	广东三维家信息科技有限公司
宋镇淇	3D中台技术部	广东三维家信息科技有限公司
游志德	3D中台技术部	广东三维家信息科技有限公司
徐冠聪	3D中台技术部	广东三维家信息科技有限公司
唐梓桓	3D中台技术部	广东三维家信息科技有限公司
王立忠	3D中台技术部	广东三维家信息科技有限公司
杨嘉杏	3D中台技术组	广东三维家信息科技有限公司
邱冰娜	AI商业化产品组	广东三维家信息科技有限公司
王志娜	AI商业化产品组	广东三维家信息科技有限公司
刘玉华	BIM组	广东三维家信息科技有限公司
梁文岚	BIM组	广东三维家信息科技有限公司
李柳奇	BIM组	广东三维家信息科技有限公司
杜春浩	BIM组	广东三维家信息科技有限公司
冯奕凯	BIM组	广东三维家信息科技有限公司
陈克豹	BIM组	广东三维家信息科技有限公司
陈海滨	BIM组	广东三维家信息科技有限公司
邹兵	BIM组	广东三维家信息科技有限公司
王建刚	CAD产品技术部	广东三维家信息科技有限公司
刘瑾	CAD产品技术部	广东三维家信息科技有限公司
邹秉坤	CAD产品技术部	广东三维家信息科技有限公司
张子硕	CAD产品技术部	广东三维家信息科技有限公司
胡雯倩	CAD产品技术部	广东三维家信息科技有限公司
丁冠杰	CAD产品技术部	广东三维家信息科技有限公司
刘万强	KA测试组	广东三维家信息科技有限公司
陈晖	KA测试组	广东三维家信息科技有限公司
王蒙锦	KA测试组	广东三维家信息科技有限公司
马阳	KA测试组	广东三维家信息科技有限公司
陈嘉莉	KA产品组	广东三维家信息科技有限公司
施冬冬	KA产品组	广东三维家信息科技有限公司
章思	KA产品组	广东三维家信息科技有限公司
郑博伦	KA华东欧派组	广东三维家信息科技有限公司
梅琪	KA华东欧派组	广东三维家信息科技有限公司
石求伟	KA华南欧派组	广东三维家信息科技有限公司
罗建敏	KA华南欧派组	广东三维家信息科技有限公司
钱剑锋	KA解决方案组	广东三维家信息科技有限公司
郑成	KA解决方案组	广东三维家信息科技有限公司
吉杨	KA通用组	广东三维家信息科技有限公司
陈志鑫	KA销售部	广东三维家信息科技有限公司
薛明	KA销售部	广东三维家信息科技有限公司
曹冲	KA销售部	广东三维家信息科技有限公司
李中原	KA销售部	广东三维家信息科技有限公司
徐诗咏	KA销售部	广东三维家信息科技有限公司
刘国珍	KA销售部	广东三维家信息科技有限公司
陈建华	KA销售部	广东三维家信息科技有限公司
董永雷	KA销售部	广东三维家信息科技有限公司
黄子珊	KA销售部	广东三维家信息科技有限公司
赵睿宁	KA销售部	广东三维家信息科技有限公司
邓鹏	KA销售部	广东三维家信息科技有限公司
颜普	KA销售部	广东三维家信息科技有限公司
全志超	KA销售部	广东三维家信息科技有限公司
顾梦雅	KA销售部	广东三维家信息科技有限公司
骆大鹏	KA销售部	广东三维家信息科技有限公司
许振海	KA销售部	广东三维家信息科技有限公司
谈青青	UED	广东三维家信息科技有限公司
刘松松	WebCAD项目组	广东三维家信息科技有限公司
苏朝辉	财务部	广东三维家信息科技有限公司
俞麟	财务部公共	广东三维家信息科技有限公司
陈腾星	财务管理组	广东三维家信息科技有限公司
曹健	产品设计组	广东三维家信息科技有限公司
叶杜如	产品设计组	广东三维家信息科技有限公司
翁海霞	产品设计组	广东三维家信息科技有限公司
蔡彦龙	产品设计组	广东三维家信息科技有限公司
周园	产品设计组	广东三维家信息科技有限公司
詹钰琪	产品组	广东三维家信息科技有限公司
陈耿镇	产品组	广东三维家信息科技有限公司
马晓敏	产品组	广东三维家信息科技有限公司
何昌健	产品组	广东三维家信息科技有限公司
刘菲	产品组	广东三维家信息科技有限公司
邹文文	产品组	广东三维家信息科技有限公司
邱晓微	产品组	广东三维家信息科技有限公司
丘世文	产品组	广东三维家信息科技有限公司
朱正	产品组	广东三维家信息科技有限公司
邱卓尔	产品组	广东三维家信息科技有限公司
林友燕	产品组	广东三维家信息科技有限公司
王雁祥	产品组	广东三维家信息科技有限公司
彭晶	产品组	广东三维家信息科技有限公司
许加富	产业联合发展部	广东三维家信息科技有限公司
王小昊	超体产品技术部	广东三维家信息科技有限公司
钟文豪	成都销售部(新零售)	广东三维家信息科技有限公司
邹东杉	成都销售部(新零售)	广东三维家信息科技有限公司
祝瑞	成都销售部(新零售)	广东三维家信息科技有限公司
阳鹏	成都销售二部(定制)	广东三维家信息科技有限公司
朱斯泽	成都销售二部(定制)	广东三维家信息科技有限公司
潘成	成都销售二部(定制)	广东三维家信息科技有限公司
高玉红	成都销售一部(定制)	广东三维家信息科技有限公司
赖泽强	成都销售一部(定制)	广东三维家信息科技有限公司
李斌和	成都销售一部(定制)	广东三维家信息科技有限公司
周蓓	成都销售一部(定制)	广东三维家信息科技有限公司
夏基全	成都销售一部(定制)	广东三维家信息科技有限公司
赵华阁	成都销售一部(定制)	广东三维家信息科技有限公司
廖常富	瓷卫销售二部	广东三维家信息科技有限公司
邓金涛	瓷卫销售二部	广东三维家信息科技有限公司
梁添明	瓷卫销售二部	广东三维家信息科技有限公司
卢志伟	瓷卫销售二部	广东三维家信息科技有限公司
梁永成	瓷卫销售二部	广东三维家信息科技有限公司
李健恒	瓷卫销售二部	广东三维家信息科技有限公司
杜湛强	瓷卫销售三部	广东三维家信息科技有限公司
曹志敏	瓷卫销售三部	广东三维家信息科技有限公司
左磊	瓷卫销售三部	广东三维家信息科技有限公司
李永秀	瓷卫销售三部	广东三维家信息科技有限公司
王霄宁	瓷卫销售一部	广东三维家信息科技有限公司
关权煜	瓷卫销售一部	广东三维家信息科技有限公司
黄汝洲	瓷卫销售一部	广东三维家信息科技有限公司
梁振邦	瓷卫销售一部	广东三维家信息科技有限公司
李文早	瓷卫销售一部	广东三维家信息科技有限公司
马晓光	瓷卫销售一部	广东三维家信息科技有限公司
陈柳鹏	大数据技术组	广东三维家信息科技有限公司
吴龙韬	大数据技术组	广东三维家信息科技有限公司
何文彬	定制硬装产品技术部	广东三维家信息科技有限公司
姚志伟	定制硬装产品技术部	广东三维家信息科技有限公司
胡俊敏	定制硬装产品技术部	广东三维家信息科技有限公司
张玲芳	定制硬装产品技术部	广东三维家信息科技有限公司
吴梓佳	定制硬装产品技术部	广东三维家信息科技有限公司
周浩	定制硬装产品技术部	广东三维家信息科技有限公司
邓智韬	定制硬装产品技术部	广东三维家信息科技有限公司
卫智斌	定制硬装产品技术部	广东三维家信息科技有限公司
刘艳	定制硬装产品技术部	广东三维家信息科技有限公司
王晓博	东北销售部(定制)	广东三维家信息科技有限公司
郑权	东北销售部(定制)	广东三维家信息科技有限公司
王雪峰	东北销售部(定制)	广东三维家信息科技有限公司
葛建波	东北销售部(定制)	广东三维家信息科技有限公司
宋凯	东北销售部(定制)	广东三维家信息科技有限公司
于海越	东北销售部(定制)	广东三维家信息科技有限公司
苏鹏	东北销售部(定制)	广东三维家信息科技有限公司
焦佳佳	东北销售部(定制)	广东三维家信息科技有限公司
王永波	东北销售部(定制)	广东三维家信息科技有限公司
崔增琦	东北销售部(新零售)	广东三维家信息科技有限公司
何贤亮	鄂赣销售部	广东三维家信息科技有限公司
王磊	鄂赣销售部	广东三维家信息科技有限公司
吴悠	鄂赣销售部	广东三维家信息科技有限公司
王超	鄂赣销售部	广东三维家信息科技有限公司
李海帆	二组	广东三维家信息科技有限公司
范翠姑	二组	广东三维家信息科技有限公司
朱霞泳	二组	广东三维家信息科技有限公司
张兵	二组	广东三维家信息科技有限公司
黄佳莉	二组	广东三维家信息科技有限公司
曾凡婷	二组	广东三维家信息科技有限公司
黄华萍	二组	广东三维家信息科技有限公司
陈亮煌	二组	广东三维家信息科技有限公司
钟恰	二组	广东三维家信息科技有限公司
贺海波	二组	广东三维家信息科技有限公司
冯玉娴	二组	广东三维家信息科技有限公司
蔡华强	二组	广东三维家信息科技有限公司
刘晓天	二组	广东三维家信息科技有限公司
潘碧君	二组	广东三维家信息科技有限公司
刘灿	二组	广东三维家信息科技有限公司
张杰鑫	二组	广东三维家信息科技有限公司
温仕亮	二组	广东三维家信息科技有限公司
刘丹	二组	广东三维家信息科技有限公司
罗松涛	二组	广东三维家信息科技有限公司
王明亮	二组	广东三维家信息科技有限公司
杨志兴	二组	广东三维家信息科技有限公司
李镜明	二组	广东三维家信息科技有限公司
曾国飞	二组	广东三维家信息科技有限公司
冯晓敏	佛山销售部(定制)	广东三维家信息科技有限公司
谢过房	佛山销售部(定制)	广东三维家信息科技有限公司
黄帆	佛山销售部(定制)	广东三维家信息科技有限公司
肖志桐	佛山销售部(定制)	广东三维家信息科技有限公司
罗云智	佛山销售部(定制)	广东三维家信息科技有限公司
周少川	佛山销售部(定制)	广东三维家信息科技有限公司
林智勇	佛山销售二部(新零售)	广东三维家信息科技有限公司
李淑慧	佛山销售一部(新零售)	广东三维家信息科技有限公司
李艳乔	佛山销售一部(新零售)	广东三维家信息科技有限公司
江华青	佛山销售一部(新零售)	广东三维家信息科技有限公司
程建安	佛山销售一部(新零售)	广东三维家信息科技有限公司
蔡福安	福建销售部(定制)	广东三维家信息科技有限公司
詹建勤	公共服务部	广东三维家信息科技有限公司
林蝶	公共服务部	广东三维家信息科技有限公司
杨娜	公共服务部	广东三维家信息科技有限公司
李晓欣	公共培训组	广东三维家信息科技有限公司
郑乔纯	公共培训组	广东三维家信息科技有限公司
伍英翘	公共培训组	广东三维家信息科技有限公司
李云杰	广东瓷卫销售部	广东三维家信息科技有限公司
凌颖杰	广深销售部(新零售)	广东三维家信息科技有限公司
温必生	广深销售部(新零售)	广东三维家信息科技有限公司
邱海峰	广州销售部(定制)	广东三维家信息科技有限公司
谭振宇	广州销售部(定制)	广东三维家信息科技有限公司
姚志文	广州销售部(定制)	广东三维家信息科技有限公司
宾招其	广州销售部(定制)	广东三维家信息科技有限公司
刘盛彬	广州销售部(定制)	广东三维家信息科技有限公司
林泽毫	广州销售部(定制)	广东三维家信息科技有限公司
廖凯威	广州销售部(定制)	广东三维家信息科技有限公司
周魁	广州销售部(定制)	广东三维家信息科技有限公司
林茂权	广州销售部(定制)	广东三维家信息科技有限公司
施浩	行业解决方案部	广东三维家信息科技有限公司
沈大富	行业解决方案部	广东三维家信息科技有限公司
徐少卿	合肥销售部(定制)	广东三维家信息科技有限公司
梁建飞	合肥销售部(定制)	广东三维家信息科技有限公司
李强	合肥销售部(定制)	广东三维家信息科技有限公司
王磊	合肥销售部(定制)	广东三维家信息科技有限公司
潘涛	合肥销售部(定制)	广东三维家信息科技有限公司
宋启明	河南销售部	广东三维家信息科技有限公司
吴川雄	河南销售部	广东三维家信息科技有限公司
王小雪	河南销售部	广东三维家信息科技有限公司
赵亮	河南销售部	广东三维家信息科技有限公司
黎海懋	核心支撑技术部	广东三维家信息科技有限公司
雷书剑	核心支撑技术部	广东三维家信息科技有限公司
庄建超	核心支撑技术部	广东三维家信息科技有限公司
刘水新	核心支撑技术部	广东三维家信息科技有限公司
赵钦吉	核心支撑技术部	广东三维家信息科技有限公司
李梁	核心支撑技术部	广东三维家信息科技有限公司
林斌	核心支撑技术部	广东三维家信息科技有限公司
李南飞	核心支撑技术部	广东三维家信息科技有限公司
张乐城	核心支撑技术部	广东三维家信息科技有限公司
唐瀚	核心支撑技术部	广东三维家信息科技有限公司
李怀胜	后端技术组	广东三维家信息科技有限公司
李沛奎	后端技术组	广东三维家信息科技有限公司
幸鑫涛	后端技术组	广东三维家信息科技有限公司
郭舒平	后端技术组	广东三维家信息科技有限公司
李勇	后端技术组	广东三维家信息科技有限公司
李星亮	后端技术组	广东三维家信息科技有限公司
罗健合	后端技术组	广东三维家信息科技有限公司
张健文	后端技术组	广东三维家信息科技有限公司
蒋超	后端技术组	广东三维家信息科技有限公司
谢跃	后端技术组	广东三维家信息科技有限公司
刘艳明	后端技术组	广东三维家信息科技有限公司
张祖基	后端技术组	广东三维家信息科技有限公司
欧龙文	后端技术组	广东三维家信息科技有限公司
周晓德	后端技术组	广东三维家信息科技有限公司
关健焯	后端技术组	广东三维家信息科技有限公司
钟君辉	后端技术组	广东三维家信息科技有限公司
张惠雄	后端技术组	广东三维家信息科技有限公司
袁煜钊	后端技术组	广东三维家信息科技有限公司
余佳	湖南销售部	广东三维家信息科技有限公司
凡志华	湖南销售部	广东三维家信息科技有限公司
沈启福	湖南销售部	广东三维家信息科技有限公司
魏杰	湖南销售部	广东三维家信息科技有限公司
王豪	湖南销售部	广东三维家信息科技有限公司
程楚阳	沪苏销售部(定制)	广东三维家信息科技有限公司
赵建淞	沪苏销售部(定制)	广东三维家信息科技有限公司
谢文红	沪苏销售部(定制)	广东三维家信息科技有限公司
姚艾鑫	沪苏销售部(定制)	广东三维家信息科技有限公司
梁秋菊	沪苏销售部(新零售)	广东三维家信息科技有限公司
张家鑫	沪苏销售部(新零售)	广东三维家信息科技有限公司
王超	华北区	广东三维家信息科技有限公司
曹旭东	华东区	广东三维家信息科技有限公司
卢志强	华东项目实施部	广东三维家信息科技有限公司
权备战	华东项目实施部	广东三维家信息科技有限公司
何明	华东项目实施部	广东三维家信息科技有限公司
潘军	华东项目实施部	广东三维家信息科技有限公司
张红群	华东项目实施部	广东三维家信息科技有限公司
韩冰	华东项目实施部	广东三维家信息科技有限公司
赵衍振	华东项目实施部	广东三维家信息科技有限公司
黄金丽	华南东区	广东三维家信息科技有限公司
黎康辉	华南东区	广东三维家信息科技有限公司
蒋志辉	华南西区	广东三维家信息科技有限公司
龙科	华南西区	广东三维家信息科技有限公司
谢贵林	华西项目实施部	广东三维家信息科技有限公司
杨鸿鸣	华西项目实施部	广东三维家信息科技有限公司
杨平	华西项目实施部	广东三维家信息科技有限公司
柯位贤	华中区	广东三维家信息科技有限公司
冼晓珍	基础产品组	广东三维家信息科技有限公司
苏靖新	技术应用组	广东三维家信息科技有限公司
李建业	技术应用组	广东三维家信息科技有限公司
庞海龙	技术应用组	广东三维家信息科技有限公司
邱辉平	技术应用组	广东三维家信息科技有限公司
梁嘉玲	技术应用组	广东三维家信息科技有限公司
陈勇星	技术应用组	广东三维家信息科技有限公司
江博文	技术组	广东三维家信息科技有限公司
黎洪武	技术组	广东三维家信息科技有限公司
顾维尧	技术组	广东三维家信息科技有限公司
陈积华	技术组	广东三维家信息科技有限公司
洪桂全	技术组	广东三维家信息科技有限公司
任瑞慧	技术组	广东三维家信息科技有限公司
黄涌鑫	技术组	广东三维家信息科技有限公司
曾嘉维	技术组	广东三维家信息科技有限公司
佘朝杭	技术组	广东三维家信息科技有限公司
罗征斌	技术组	广东三维家信息科技有限公司
李旺	技术组	广东三维家信息科技有限公司
张欢	技术组	广东三维家信息科技有限公司
张杰	技术组	广东三维家信息科技有限公司
张有静	技术组	广东三维家信息科技有限公司
戴蕾	技术组	广东三维家信息科技有限公司
李奇奇	技术组	广东三维家信息科技有限公司
毛紫君	技术组	广东三维家信息科技有限公司
袁李道	技术组	广东三维家信息科技有限公司
陆一帆	技术组	广东三维家信息科技有限公司
郭杰伦	技术组	广东三维家信息科技有限公司
罗雪飞	技术组	广东三维家信息科技有限公司
何华成	技术组	广东三维家信息科技有限公司
吴颖琳	技术组	广东三维家信息科技有限公司
黄子沣	技术组	广东三维家信息科技有限公司
钟俊滨	技术组	广东三维家信息科技有限公司
冯玲钰	技术组	广东三维家信息科技有限公司
钟廷员	技术组	广东三维家信息科技有限公司
周芹	技术组	广东三维家信息科技有限公司
冯凯钧	技术组	广东三维家信息科技有限公司
王程飞	济南销售部(定制)	广东三维家信息科技有限公司
唐少功	济南销售部(定制)	广东三维家信息科技有限公司
李振	济南销售部(定制)	广东三维家信息科技有限公司
郭D	济南销售部(定制)	广东三维家信息科技有限公司
肖敬坤	济南销售部(定制)	广东三维家信息科技有限公司
朱超	济南销售部(定制)	广东三维家信息科技有限公司
孟超	济南销售部(定制)	广东三维家信息科技有限公司
苑少剑	京津晋冀销售部(定制)	广东三维家信息科技有限公司
李亚洲	京津晋冀销售部(定制)	广东三维家信息科技有限公司
蒋世平	京津晋冀销售部(定制)	广东三维家信息科技有限公司
刘欢	京津晋冀销售部(定制)	广东三维家信息科技有限公司
吕文辉	京津晋冀销售部(新零售)	广东三维家信息科技有限公司
刘燕	客服部	广东三维家信息科技有限公司
梁思思	客服部	广东三维家信息科技有限公司
曾炜玲	客服部	广东三维家信息科技有限公司
练俊杰	客服部	广东三维家信息科技有限公司
陈乐乐	客服部	广东三维家信息科技有限公司
李进	客服部	广东三维家信息科技有限公司
杜燕兰	客服部	广东三维家信息科技有限公司
兰小珍	客服部	广东三维家信息科技有限公司
刘东艺	客服部	广东三维家信息科技有限公司
张俊东	客服部	广东三维家信息科技有限公司
周建广	客服部	广东三维家信息科技有限公司
彭文娟	客服部	广东三维家信息科技有限公司
李云庆	临沂销售部(定制)	广东三维家信息科技有限公司
赵全宝	临沂销售部(定制)	广东三维家信息科技有限公司
杨珂	临沂销售部(定制)	广东三维家信息科技有限公司
唐红霞	零售二部二组	广东三维家信息科技有限公司
符小平	零售二部二组	广东三维家信息科技有限公司
杨小楷	零售二部二组	广东三维家信息科技有限公司
谢广桐	零售二部二组	广东三维家信息科技有限公司
李巧琳	零售二部二组	广东三维家信息科技有限公司
李志臻	零售二部二组	广东三维家信息科技有限公司
朱凌波	零售二部二组	广东三维家信息科技有限公司
谭兆麟	零售二部二组	广东三维家信息科技有限公司
毛婷婷	零售二部二组	广东三维家信息科技有限公司
张美怡	零售二部三组	广东三维家信息科技有限公司
蔡少丽	零售二部三组	广东三维家信息科技有限公司
罗盼	零售二部三组	广东三维家信息科技有限公司
易柏玲	零售二部三组	广东三维家信息科技有限公司
郑灿健	零售二部一组	广东三维家信息科技有限公司
吴志云	零售二部一组	广东三维家信息科技有限公司
江婉筠	零售二部一组	广东三维家信息科技有限公司
张艺	零售二部一组	广东三维家信息科技有限公司
李相明	零售二部一组	广东三维家信息科技有限公司
余智伟	零售二部一组	广东三维家信息科技有限公司
韩秉哲	零售二部一组	广东三维家信息科技有限公司
李娟	零售三部	广东三维家信息科技有限公司
章继超	零售三部二组	广东三维家信息科技有限公司
王骁	零售三部二组	广东三维家信息科技有限公司
刘微	零售三部二组	广东三维家信息科技有限公司
徐露	零售三部二组	广东三维家信息科技有限公司
张正辉	零售三部二组	广东三维家信息科技有限公司
尹航	零售三部二组	广东三维家信息科技有限公司
李锋	零售三部三组	广东三维家信息科技有限公司
顾薛菲	零售三部三组	广东三维家信息科技有限公司
夏明雨	零售三部一组	广东三维家信息科技有限公司
马建红	零售三部一组	广东三维家信息科技有限公司
张梦梦	零售三部一组	广东三维家信息科技有限公司
李	零售三部一组	广东三维家信息科技有限公司
罗辉	零售四部	广东三维家信息科技有限公司
李泰炜	零售四部二组	广东三维家信息科技有限公司
潘振业	零售四部二组	广东三维家信息科技有限公司
彭吉武	零售四部二组	广东三维家信息科技有限公司
林咏豪	零售四部二组	广东三维家信息科技有限公司
李柏含	零售四部二组	广东三维家信息科技有限公司
曾万兵	零售四部二组	广东三维家信息科技有限公司
钟永文	零售四部三组	广东三维家信息科技有限公司
熊贝贝	零售四部一组	广东三维家信息科技有限公司
谢魏	零售四部一组	广东三维家信息科技有限公司
汪俊科	零售四部一组	广东三维家信息科技有限公司
张晓灿	零售四部一组	广东三维家信息科技有限公司
苏超明	零售五部	广东三维家信息科技有限公司
吴倩玲	零售五部	广东三维家信息科技有限公司
倪丽敏	零售五部	广东三维家信息科技有限公司
韦伟	零售五部	广东三维家信息科技有限公司
方焕祺	零售五部	广东三维家信息科技有限公司
吴志华	零售五部	广东三维家信息科技有限公司
范仰东	零售五部	广东三维家信息科技有限公司
陆婷	零售一部	广东三维家信息科技有限公司
廖红波	零售一部二组	广东三维家信息科技有限公司
李远方	零售一部二组	广东三维家信息科技有限公司
覃莉	零售一部二组	广东三维家信息科技有限公司
方锦漂	零售一部二组	广东三维家信息科技有限公司
邝辉	零售一部二组	广东三维家信息科技有限公司
施伟烽	零售一部二组	广东三维家信息科技有限公司
邱梓雄	零售一部二组	广东三维家信息科技有限公司
王际珍	零售一部三组	广东三维家信息科技有限公司
张德玉	零售一部三组	广东三维家信息科技有限公司
吴开记	零售一部三组	广东三维家信息科技有限公司
高福勤	零售一部三组	广东三维家信息科技有限公司
王弘扬	零售一部三组	广东三维家信息科技有限公司
邓晓颖	零售一部三组	广东三维家信息科技有限公司
纪树泽	零售一部三组	广东三维家信息科技有限公司
郑东兴	零售一部四组	广东三维家信息科技有限公司
杜海薇	零售一部四组	广东三维家信息科技有限公司
周栩仪	零售一部四组	广东三维家信息科技有限公司
周伟达	零售一部一组	广东三维家信息科技有限公司
马盛荣	零售一部一组	广东三维家信息科技有限公司
李炜	零售一部一组	广东三维家信息科技有限公司
方浩扬	零售一部一组	广东三维家信息科技有限公司
宋健翔	零售一部一组	广东三维家信息科技有限公司
蔡熳洁	零售一部一组	广东三维家信息科技有限公司
王娜	零售中心	广东三维家信息科技有限公司
吴维川	媒介公关组	广东三维家信息科技有限公司
万锶滢	媒介公关组	广东三维家信息科技有限公司
劳莎	媒介公关组	广东三维家信息科技有限公司
乔耀莹	媒介公关组	广东三维家信息科技有限公司
李广锡	美家平台事业部	广东三维家信息科技有限公司
林楚明	美家平台事业部公共	广东三维家信息科技有限公司
翟元志	内容制作组	广东三维家信息科技有限公司
林上雯	内容制作组	广东三维家信息科技有限公司
钟家璇	内容制作组	广东三维家信息科技有限公司
黄智谧	内容制作组	广东三维家信息科技有限公司
林培勇	内容制作组	广东三维家信息科技有限公司
麦嘉丽	内容制作组	广东三维家信息科技有限公司
周玉敏	内容制作组	广东三维家信息科技有限公司
区楚怡	内容制作组	广东三维家信息科技有限公司
秦维锋	内容制作组	广东三维家信息科技有限公司
李旖璇	培训推广组	广东三维家信息科技有限公司
张燕	培训推广组	广东三维家信息科技有限公司
刁润秋	培训推广组	广东三维家信息科技有限公司
吴庶熙	培训推广组	广东三维家信息科技有限公司
龚志豪	培训推广组	广东三维家信息科技有限公司
李思桦	培训推广组	广东三维家信息科技有限公司
李文斌	培训推广组	广东三维家信息科技有限公司
谯娟	培训推广组	广东三维家信息科技有限公司
吴志伟	培训推广组	广东三维家信息科技有限公司
王培培	培训推广组	广东三维家信息科技有限公司
姚昌	培训推广组	广东三维家信息科技有限公司
张佳佳	培训推广组	广东三维家信息科技有限公司
林淑贤	培训推广组	广东三维家信息科技有限公司
刘明志	培训推广组	广东三维家信息科技有限公司
梁永毅	培训推广组	广东三维家信息科技有限公司
徐平	培训推广组	广东三维家信息科技有限公司
孔阳	培训推广组	广东三维家信息科技有限公司
梅园园	培训推广组	广东三维家信息科技有限公司
周军年	平台测试组	广东三维家信息科技有限公司
杨丽	平台测试组	广东三维家信息科技有限公司
王亚飞	平台测试组	广东三维家信息科技有限公司
阳冰	平台测试组	广东三维家信息科技有限公司
卢洲	平台测试组	广东三维家信息科技有限公司
侯旭	平台测试组	广东三维家信息科技有限公司
石畅畅	平台体验组	广东三维家信息科技有限公司
陈晨	平台体验组	广东三维家信息科技有限公司
夏裕	平台体验组	广东三维家信息科技有限公司
梁嘉敏	平台体验组	广东三维家信息科技有限公司
黄珏碧	平台体验组	广东三维家信息科技有限公司
梁彩欣	平台体验组	广东三维家信息科技有限公司
杨雪	平台体验组	广东三维家信息科技有限公司
李桐岩	前端技术组	广东三维家信息科技有限公司
叶明艺	前端技术组	广东三维家信息科技有限公司
尹杰	前端技术组	广东三维家信息科技有限公司
宿淑娟	前端技术组	广东三维家信息科技有限公司
柯织红	前端技术组	广东三维家信息科技有限公司
刘凯	前端技术组	广东三维家信息科技有限公司
许家淇	前端技术组	广东三维家信息科技有限公司
刘雅倩	前端技术组	广东三维家信息科技有限公司
潘光烽	前端技术组	广东三维家信息科技有限公司
黄志鹏	前端技术组	广东三维家信息科技有限公司
刘梅	前端技术组	广东三维家信息科技有限公司
张超	琼桂销售部	广东三维家信息科技有限公司
罗挺	琼桂销售部	广东三维家信息科技有限公司
温富华	琼桂销售部	广东三维家信息科技有限公司
汪晨	渠道拓展组	广东三维家信息科技有限公司
杨豪	渠道拓展组	广东三维家信息科技有限公司
黄滢	渠道拓展组	广东三维家信息科技有限公司
丁琼英	渠道拓展组	广东三维家信息科技有限公司
钟国强	渠道拓展组	广东三维家信息科技有限公司
吴冰	渠道拓展组	广东三维家信息科技有限公司
林锦城	渠道拓展组	广东三维家信息科技有限公司
何志强	渠道拓展组	广东三维家信息科技有限公司
王金丹	渠道拓展组	广东三维家信息科技有限公司
蔡利华	渠道拓展组	广东三维家信息科技有限公司
程世宇	渠道拓展组	广东三维家信息科技有限公司
陈海城	全屋定制组	广东三维家信息科技有限公司
陈永军	全屋定制组	广东三维家信息科技有限公司
孔子阳	全屋定制组	广东三维家信息科技有限公司
李迅	全屋定制组	广东三维家信息科技有限公司
袁梓埠	全屋定制组	广东三维家信息科技有限公司
吴鑫桂	全屋定制组	广东三维家信息科技有限公司
区泳铟	人力资源部	广东三维家信息科技有限公司
刘小燕	人力资源部	广东三维家信息科技有限公司
陈晓玲	人力资源部	广东三维家信息科技有限公司
邓晓燕	人力资源部	广东三维家信息科技有限公司
兰兰	人力资源部	广东三维家信息科技有限公司
邓梅平	人力资源部	广东三维家信息科技有限公司
张舒弥	人力资源部	广东三维家信息科技有限公司
阳桃	人力资源部	广东三维家信息科技有限公司
周昭泽	人力资源部	广东三维家信息科技有限公司
陈才显	人力资源部	广东三维家信息科技有限公司
王晓雪	人力资源部	广东三维家信息科技有限公司
吴泽颖	人力资源部	广东三维家信息科技有限公司
黄育璇	人力资源部	广东三维家信息科技有限公司
余锶鸿	人力资源部	广东三维家信息科技有限公司
苗千	人力资源部	广东三维家信息科技有限公司
戴丽英	人力资源部	广东三维家信息科技有限公司
杨紫娟	人力资源部	广东三维家信息科技有限公司
刘晓玲	人力资源部	广东三维家信息科技有限公司
谭满旋	三维家设计学院	广东三维家信息科技有限公司
陈志群	三维家设计学院	广东三维家信息科技有限公司
聂莉	商务支持组	广东三维家信息科技有限公司
詹青梅	商务支持组	广东三维家信息科技有限公司
杨菲菲	商务支持组	广东三维家信息科技有限公司
张光皓	商务组	广东三维家信息科技有限公司
黄志远	商务组	广东三维家信息科技有限公司
李许冠	商务组	广东三维家信息科技有限公司
吕云良	商务组	广东三维家信息科技有限公司
马艺雄	商务组	广东三维家信息科技有限公司
黎芷源	商务组	广东三维家信息科技有限公司
邓警江	商务组	广东三维家信息科技有限公司
银志兴	商务组	广东三维家信息科技有限公司
蒋壮	商务组	广东三维家信息科技有限公司
吴婉婷	商务组	广东三维家信息科技有限公司
陈雄	深度算法组	广东三维家信息科技有限公司
雷瑞生	深度算法组	广东三维家信息科技有限公司
卢燕青	深度算法组	广东三维家信息科技有限公司
喻一凡	深度算法组	广东三维家信息科技有限公司
王胜	深度算法组	广东三维家信息科技有限公司
施贤	深度算法组	广东三维家信息科技有限公司
林上钧	深度算法组	广东三维家信息科技有限公司
杨嘉华	深度算法组	广东三维家信息科技有限公司
王松	深度算法组	广东三维家信息科技有限公司
王璐	深度算法组	广东三维家信息科技有限公司
叶海	深度算法组	广东三维家信息科技有限公司
施伟德	深圳销售部(定制)	广东三维家信息科技有限公司
陈新荣	深圳销售部(定制)	广东三维家信息科技有限公司
姚灿豪	深圳销售部(定制)	广东三维家信息科技有限公司
黎容健	深圳销售部(定制)	广东三维家信息科技有限公司
孙巧玲	生产技术组	广东三维家信息科技有限公司
冯欢泉	生产技术组	广东三维家信息科技有限公司
王良辉	生产技术组	广东三维家信息科技有限公司
苏镇城	生产技术组	广东三维家信息科技有限公司
冯举	生产技术组	广东三维家信息科技有限公司
林志盛	生产技术组	广东三维家信息科技有限公司
苏捷林	生产技术组	广东三维家信息科技有限公司
蔡伟斌	生产技术组	广东三维家信息科技有限公司
刘洲	生产技术组	广东三维家信息科技有限公司
吴毅滔	生产技术组	广东三维家信息科技有限公司
张兆龙	生产技术组	广东三维家信息科技有限公司
陈雄伟	生产技术组	广东三维家信息科技有限公司
曾石养	事业综合组	广东三维家信息科技有限公司
蒋程琴	事业综合组	广东三维家信息科技有限公司
张欣	事业综合组	广东三维家信息科技有限公司
蔡少婉	事业综合组	广东三维家信息科技有限公司
梁小俊	事业综合组	广东三维家信息科技有限公司
张思思	事业综合组	广东三维家信息科技有限公司
李小君	事业综合组	广东三维家信息科技有限公司
曾嘉	事业综合组	广东三维家信息科技有限公司
陈健	事业综合组	广东三维家信息科技有限公司
林雁娟	数据组	广东三维家信息科技有限公司
孙春飞	数控产品事业部	广东三维家信息科技有限公司
王占平	数控技术组	广东三维家信息科技有限公司
黄国飞	数控技术组	广东三维家信息科技有限公司
张振维	数控技术组	广东三维家信息科技有限公司
张杰	数控技术组	广东三维家信息科技有限公司
梁仁	数控技术组	广东三维家信息科技有限公司
阳展	数控技术组	广东三维家信息科技有限公司
王源志	数控技术组	广东三维家信息科技有限公司
陈航	数控技术组	广东三维家信息科技有限公司
谢宇枫	数控技术组	广东三维家信息科技有限公司
王江鸿	数控技术组	广东三维家信息科技有限公司
谭家豪	数控销售组	广东三维家信息科技有限公司
张磊	数控销售组	广东三维家信息科技有限公司
劳春桃	推广组	广东三维家信息科技有限公司
徐洁纯	推广组	广东三维家信息科技有限公司
李淑娟	推广组	广东三维家信息科技有限公司
杜铖	皖鲁区	广东三维家信息科技有限公司
周冰欣	网站运营组	广东三维家信息科技有限公司
黎冠华	网站运营组	广东三维家信息科技有限公司
曲忠鹤	网站运营组	广东三维家信息科技有限公司
谢晓美	网站运营组	广东三维家信息科技有限公司
胡兰芳	网站运营组	广东三维家信息科技有限公司
许文坤	网站运营组	广东三维家信息科技有限公司
陈可	网站运营组	广东三维家信息科技有限公司
李梅楠	网站运营组	广东三维家信息科技有限公司
牛晓龙	西南区	广东三维家信息科技有限公司
王福辕	项目实施中心	广东三维家信息科技有限公司
余	销售管理部	广东三维家信息科技有限公司
李承欢	销售管理部公共	广东三维家信息科技有限公司
陈芷欣	销售支持部	广东三维家信息科技有限公司
赵晓琳	销售支持部	广东三维家信息科技有限公司
孙媛	销售支持部	广东三维家信息科技有限公司
李龙	新零售KA销售部	广东三维家信息科技有限公司
郑佳彬	新零售KA销售部	广东三维家信息科技有限公司
周江恒	渲染产品组	广东三维家信息科技有限公司
李志荣	渲染产品组	广东三维家信息科技有限公司
曾柏林	一组	广东三维家信息科技有限公司
韦耀腾	一组	广东三维家信息科技有限公司
梁泳珊	一组	广东三维家信息科技有限公司
谭雄记	一组	广东三维家信息科技有限公司
李燕萍	一组	广东三维家信息科技有限公司
陈燕思	一组	广东三维家信息科技有限公司
邓鹏	一组	广东三维家信息科技有限公司
徐少宏	一组	广东三维家信息科技有限公司
徐健玲	一组	广东三维家信息科技有限公司
赵崇钦	一组	广东三维家信息科技有限公司
苏玉梅	一组	广东三维家信息科技有限公司
谢禄让	一组	广东三维家信息科技有限公司
郑文丹	一组	广东三维家信息科技有限公司
苏潮云	一组	广东三维家信息科技有限公司
骆凌志	一组	广东三维家信息科技有限公司
李烨	一组	广东三维家信息科技有限公司
阮劲	一组	广东三维家信息科技有限公司
潘金明	一组	广东三维家信息科技有限公司
庞仁真	一组	广东三维家信息科技有限公司
敬晓文	一组	广东三维家信息科技有限公司
郑建榆	应用产品组	广东三维家信息科技有限公司
王金蕾	应用产品组	广东三维家信息科技有限公司
蒙虹羽	应用产品组	广东三维家信息科技有限公司
陈俊彬	应用技术组	广东三维家信息科技有限公司
邹月明	应用技术组	广东三维家信息科技有限公司
刘杰文	应用技术组	广东三维家信息科技有限公司
陈婵	用户服务中心	广东三维家信息科技有限公司
梁树峰	用户服务中心公共	广东三维家信息科技有限公司
谢喜全	用户服务中心公共	广东三维家信息科技有限公司
姜岚	用户服务中心公共	广东三维家信息科技有限公司
苏嘉明	用户服务中心公共	广东三维家信息科技有限公司
张建鑫	用户服务中心公共	广东三维家信息科技有限公司
丘伟导	用户体验组	广东三维家信息科技有限公司
符啸	云贵销售部	广东三维家信息科技有限公司
陈洪	云贵销售部	广东三维家信息科技有限公司
丁馨	云贵销售部	广东三维家信息科技有限公司
曾茂	云贵销售部	广东三维家信息科技有限公司
何龙兴	云渲染开发组	广东三维家信息科技有限公司
卢健智	云渲染开发组	广东三维家信息科技有限公司
王远鹏	云渲染开发组	广东三维家信息科技有限公司
龚四维	云渲染开发组	广东三维家信息科技有限公司
陆伟春	云渲染开发组	广东三维家信息科技有限公司
韩立畴	云渲染开发组	广东三维家信息科技有限公司
何达炜	云渲染开发组	广东三维家信息科技有限公司
杨龙	云渲染开发组	广东三维家信息科技有限公司
钟永红	运行平台组	广东三维家信息科技有限公司
陈江豪	运行平台组	广东三维家信息科技有限公司
邝耀宗	运行平台组	广东三维家信息科技有限公司
刘志伟	运行平台组	广东三维家信息科技有限公司
张中华	运行平台组	广东三维家信息科技有限公司
彭镇山	运营策划组	广东三维家信息科技有限公司
郑坤腾	运营策划组	广东三维家信息科技有限公司
何九卡	运营策划组	广东三维家信息科技有限公司
廖夏玲	运营支持部	广东三维家信息科技有限公司
曾玲晖	运营支持部	广东三维家信息科技有限公司
董玲	运营支持部	广东三维家信息科技有限公司
徐莉慧	运营支持部	广东三维家信息科技有限公司
周洁清	运营支持部	广东三维家信息科技有限公司
谌俊帆	运营支持部	广东三维家信息科技有限公司
龙雁珍	运营支持部	广东三维家信息科技有限公司
李霞	运营支持部	广东三维家信息科技有限公司
黄柏凌	运营组	广东三维家信息科技有限公司
林梓琴	运营组	广东三维家信息科技有限公司
张蓉	运营组	广东三维家信息科技有限公司
王宇	运营组	广东三维家信息科技有限公司
夏敏	运营组	广东三维家信息科技有限公司
康钡雯	运营组	广东三维家信息科技有限公司
曾艺茹	运营组	广东三维家信息科技有限公司
蔡犁燕	运营组	广东三维家信息科技有限公司
黄立超	运营组	广东三维家信息科技有限公司
李	运营组	广东三维家信息科技有限公司
卢希跃	运营组	广东三维家信息科技有限公司
郑晨希	运营组	广东三维家信息科技有限公司
蔡裕虹	运营组	广东三维家信息科技有限公司
郑翔	运营组	广东三维家信息科技有限公司
赖嘉楠	运营组	广东三维家信息科技有限公司
马丽谊	运营组	广东三维家信息科技有限公司
冯璐	运营组	广东三维家信息科技有限公司
刘恩成	运营组	广东三维家信息科技有限公司
李涵宇	展会活动组	广东三维家信息科技有限公司
王骏逸	展会活动组	广东三维家信息科技有限公司
王兴毅	展会活动组	广东三维家信息科技有限公司
陈文杰	展会活动组	广东三维家信息科技有限公司
吴倍洲	展会活动组	广东三维家信息科技有限公司
吴冬冬	账务管理组	广东三维家信息科技有限公司
姚骏俊	账务管理组	广东三维家信息科技有限公司
温小草	账务管理组	广东三维家信息科技有限公司
刘婷	账务管理组	广东三维家信息科技有限公司
刘环琴	账务管理组	广东三维家信息科技有限公司
葛宇豪	浙江销售部(定制)	广东三维家信息科技有限公司
肖振	浙江销售部(定制)	广东三维家信息科技有限公司
周晓晓	浙江销售部(定制)	广东三维家信息科技有限公司
石水晶	浙江销售部(定制)	广东三维家信息科技有限公司
刘颖	浙江销售部(定制)	广东三维家信息科技有限公司
李显胜	浙江销售部(新零售)	广东三维家信息科技有限公司
杨慰和	质量效能部	广东三维家信息科技有限公司
郑传思	质量中台组	广东三维家信息科技有限公司
钱新乐	中控技术组	广东三维家信息科技有限公司
陈振孝	中控技术组	广东三维家信息科技有限公司
曾志炜	中控技术组	广东三维家信息科技有限公司
容准球	中控技术组	广东三维家信息科技有限公司
熊新建	中控技术组	广东三维家信息科技有限公司
梁绥泽	中控技术组	广东三维家信息科技有限公司
庞海锋	中控技术组	广东三维家信息科技有限公司
陈彬	中控技术组	广东三维家信息科技有限公司
陈荫乐	中控技术组	广东三维家信息科技有限公司
吴林飞	中山销售部	广东三维家信息科技有限公司
区杰林	中山销售部	广东三维家信息科技有限公司
董帅	中山销售部	广东三维家信息科技有限公司
张迎雪	重庆销售部	广东三维家信息科技有限公司
冉玉望	重庆销售部	广东三维家信息科技有限公司
周玉成	重庆销售部	广东三维家信息科技有限公司
赵梦晓	重庆销售部	广东三维家信息科技有限公司
		
		
		
		
		
		
		
		
